sid	text:de	actor	conv		
					
////////////////////////////////// Mission 1.1					
					
11.incoming	Vorsicht! Hier gibt es wilde Mutanten!	Onkar ni’Varra	1		
					
11.not harmless	Hier ist es nicht ungefährlich.	Onkar ni’Varra	2		
11.take troops	Denkar, nimm die Truppen und mach den Weg frei. Ich bleibe und beschütze die Techniker.	Onkar ni’Varra	2		
					
11.keep moving	Gute Arbeit, Sohn. Nur weiter!	Onkar ni’Varra	3		
					
11.we are coming	Okay, wir kommen. Macht die Straße nach Süden frei!	Onkar ni’Varra	4		
					
11.go south	Geht von hier aus nach Süden.	Onkar ni’Varra	5		
					
11.hang around	Gut! Wir arbeiten hier eine Weile. Denkar, du machst in der Zwischenzeit den weiteren Weg frei.	Onkar ni’Varra	6		
					
11.under attack-11	Denkar! Wir werden von Varun-Truppen angegriffen!	Onkar ni’Varra	7		
11.coming	Ich komme, so schnell ich kann. Halt durch!	Denkar ni’Varra	7		
11.save yourself	Nein! Es sind zu viele! Ich bin schon verloren! Rette dich, das ist ein Bef...	Onkar ni’Varra	7		
11.nooo	Vater! Nein!	Denkar ni’Varra	7		
					
11.avoid patrols	Vorsicht! Wir müssen den Wachen ausweichen, um hier lebend rauszukommen!	Denkar ni’Varra	8		
					
11.another patrol	Eine Wache, Vorsicht!	Denkar ni’Varra	9		
					
					
////////////////////////////////// Mission 1.2					
					
12.under attack-12	Das Dorf wird angegriffen! Ich muss helfen!	Denkar ni’Varra	1		
					
12.road blocked	Dünenstadt-Truppen versperren den Weg. Allein schaff ich das nicht. Ich muss Hilfe holen.	Denkar ni’Varra	2		
					
12.good start	Immerhin ein Anfang. Aber es reicht wohl noch nicht.	Denkar ni’Varra	3		
					
12.more help	Mehr Hilfe, gut. Aber noch nicht genug.	Denkar ni’Varra	4		
					
12.got help	Mehr Unterstützung kriege ich nicht. Hoffentlich reicht das.	Denkar ni’Varra	5		
					
12.still need help	Ich könnte noch Hilfe gebrauchen, um die Blockade zu durchbrechen. Ich muss welche finden!	Denkar ni’Varra	6		
					
12.break blockade	Also, versuchen wir’s. Machen wir den Weg frei!	Denkar ni’Varra	7		
					
12.village damaged	Alles steht in Flammen! Warum haben sie das getan?	Denkar ni’Varra	8		
12.push	Wir müssen mit den restlichen Verteidigern die Dünenstadt-Truppen zurückschlagen!	Denkar ni’Varra	8		
					
					
////////////////////////////////// Mission 1.3					
					
13.under attack-13	Meister Ganthu, unser Xenolit wird bedroht! Die Verteidiger brauchen Hilfe!	Wakono Scout	1		
13.take me there	Beeilen wir uns!	Ganthu	1		
					
13.last of them	Das war es wohl vorerst. Wir sollten versuchen, sie zu vertreiben, aber ihr Lager ist sicher gut geschützt.	Ganthu	2		
					
13.diversion	Die Rückseite des Lagers ist nicht bewacht, Meister Ganthu. Ein geschickter Magier könnte sie von uns ablenken.	Ragho	3		
13.i will go	Gut, ich werde versuchen, sie zu verwirren.	Ganthu	3		
					
13.kill him	Das ist er!	Ragho	4		
13.die freak	Stirb, Mutanten-Freak!	Dunetown Assassin	4		
13.trap	Ragho, wie konntest du zum Verräter werden? Ist dir dein Wunsch, Häuptling zu werden, wichtiger als der Stamm selbst?	Ganthu	4		
13.me traitor	Die Krise tut uns gut. Alle müssen begreifen, dass wir einen starken Anführer brauchen und keinen alten Gelehrten!	Ragho	4		
13.village endangered	Das Dorf ist vielleicht in Gefahr. Ragho mag verblendet sein, aber ich bezweifle, dass sich die Menschen an ihre Vereinbarung halten.	Ganthu	4		
					
13.you die eji sold	Wenn du noch so schnell bist, du schaffst es nicht! Und dein Balg wird zum Spielzeug für die Menschen!	Ragho	5		
13.not eji	Lass Eji da raus!	Ganthu	5		
13.too late	Zu spät, alter Mann, sie ist schon versprochen. Die Menschen sammeln solch seltsame Kreaturen wie sie!	Ragho	5		
					
13.use skills	Du könntest deine Magie zum Wohl des Stammes einsetzen!	Ganthu	6		
13.strong leader	Genau das tue ich! Bald hat der Stamm einen starken Anführer!	Ragho	6		
					
13.come to your senses	Es ist noch nicht zu spät, sich zu besinnen, Ragho.	Ganthu	7		
13.no turning back	Es gibt kein Zurück mehr, alter Mann!	Ragho	7		
					
13.disappeared	Er ist wieder verschwunden!	Ganthu	8		
					
13.not again	Nicht schon wieder ...	Ganthu	9		
					
13.just die	Stell dich zum Kampf, „Häuptling“!	Ganthu	10		
					
13.come	Komm, Eji, beeil dich! Ragho hat sich selbst übertroffen. Er hat einen Pakt mit den Menschen geschlossen, um Häuptling zu werden. Wir sind im Dorf nicht mehr sicher!	Ganthu	11		
13.yes master	Ich bin bereit, Meister Ganthu!	Eji	11		
					
13.give child	Halt! Du wirst nicht lebendig entkommen, Ganthu. Und das Balg hab ich den Menschen versprochen.	Ragho	12		
13.what	Was?!	Eji	11		
13.never	An Eji kommst du nur über meine Leiche, Verräter!	Ganthu	12		
					
13.enough teleporting	Neuer Häuptling, von wegen ... Aber ich fürchte, wir müssen dennoch das Dorf verlassen.	Ganthu	13		
					
13.what now	Was sollen wir jetzt tun, Meister Ganthu?	Eji	11		
13.journey	Die Zeit ist reif, dass wir deine Reise antreten, Eji.	Ganthu	13		
					
////////////////////////////////// Mission 1.4					
					
14.need diversion	Der Lagereingang ist verschlossen. Die Dünenstadt-Truppen müssen ihn öffnen.	Denkar ni’Varra	1		
14.mine nearby	Im Norden liegt eine Xenolit-Mine. Wenn wir sie mit aller Macht angreifen, schicken sie vielleicht Verstärkung durch das Tor.	Ganthu	1		
14.lets try	Das könnte klappen. Versuchen wir’s.	Denkar ni’Varra	1		
					
14.gate here	Da ist das Tor. Hoffen wir, dass es lang genug offen ist.	Ganthu	2		
					
14.get them	Die Wilden greifen uns an! Auf sie, Jungs!	Dunetown Mine Officer	3		
					
14.officer down	Ihr Offizier ist tot!	Denkar ni’Varra	4		
					
14.gate opened	Das Tor ist offen! Schnell, wir schleichen uns rein!	Ganthu	5		
					
14.what is this	Was machen all die Tiere hier?	Ganthu	6		
14.force field	Ich kann das Kraftfeld deaktivieren, damit wir vorbei können, aber ich glaube, wir sollten diese Wesen nicht befreien.	Denkar ni’Varra	6		
14.passage	Dort im Norden ist ein Durchgang. Vielleicht können wir diesen Umweg nehmen.	Ganthu	6		
					
14.unlocking	Dieses System ist fast ungesichert. Ich deaktiviere es jetzt.	Denkar ni’Varra	7		
					
14.can open but beams	Das ist die Steuerung des Nordtors! Ich kann es öffnen, aber wir müssen ums ganze Lager, um es zu benutzen!	Denkar ni’Varra	8		
					
14.can open no beams	Das ist die Steuerung des Nordtors! Ich kann es öffnen!	Denkar ni’Varra	9		
					
14.opening	Das war’s!	Denkar ni’Varra	10		
					
14.base found	Sieh dir diese Verteidigung an ... Da kommen wir nicht rein. Unsere Rache muss warten.	Denkar ni’Varra	11		
14.come get some	Alarm im äußeren Bereich! Es sind Eindringlinge im Lager!	Frank N. Stein	11		
14.duel of honor	Hoffentlich ist das Schiff nicht zu gut bewacht.	Denkar ni’Varra	11		
14.no duel	Verdoppelt die Wachen! Beseitigt alle Eindringlinge!	Frank N. Stein	11		
14.had to try	Wir müssen uns beeilen!	Denkar ni’Varra	11		
					
14.my ship	Sie wollen zu meinem Schiff! Stoppt sie!	Frank N. Stein	12		
14.hurry-14	Schnell, Denkar! Starte dieses Fluggerät! Der ganze Stützpunkt jagt uns!	Ganthu	12		
14.trying	Einen Moment noch ... Ich hab’s! Nichts wie weg hier!	Denkar ni’Varra	12		
					
					
////////////////////////////////// Mission 1.5					
					
15.here we come	Das Gelände ist gefährlich, aber wir müssten es zu Fuß zur Stadt schaffen.	Denkar ni’Varra	1		
					
15.careful-15	Vorsichtig, die Lava bricht ständig aus!	Denkar ni’Varra	2		
					
15.made through lava	Endlich haben wir diese verdammte Lava hinter uns!	Denkar ni’Varra	3		
15.respect nature	Etwas mehr Respekt vor den Mächten der Natur, Denkar.	Ganthu	3		
					
15.found saling base	Ein Saling-Lager, sehr gut! Bitten wir sie, uns zu eskortieren.	Denkar ni’Varra	4		
					
15.what the	Was zum …	Denkar ni’Varra	5		
15.treason	He! Sie haben mich doch erkannt! Warum schießen sie auf uns? Das ist Verrat!	Denkar ni’Varra	5		
15.cannot defeat	Frag sie das, wenn sie damit aufhören. Jetzt sollten wir verschwinden!	Ganthu	5		
15.passage	Ich sehe einen Durchgang, rechts vor dem Lager!	Eji	5		
					
15.past saling base	Na großartig … jetzt müssen wir uns Saling anders nähern.	Denkar ni’Varra	6		
					
15.message	Lord ni’Varra, eine Botschaft von unserem Lord Commander.	Salingian Messenger	7		
15.no chance	Denkar, Senator ni’Marten hat mir befohlen, dich aufzuhalten. Ich muss gehorchen.	Salingian Commander	7		
15.offer	Alleine hast du keine Chance gegen meine Truppen, doch ich biete dir einen Ehrenkampf: deine Einheit gegen meine, vor dem Lager.	Salingian Commander	7		
15.trap	Das kann eine Falle sein!	Ganthu	7		
15.men of honor	Ich glaube nicht. Wir Salingianer halten unser Wort.	Denkar ni’Varra	7		
15.follow me	Folgt mir, Lord ni’Varra.	Salingian Messenger	7		
					
15.lets dance	Kämpfen wir!	Denkar ni’Varra	8		
					
15.incredible	Es … ist eine Ehre, durch deine Hand zu sterben … ni’Varra!	Salingian Commander	9		
15.fought well	Gut gekämpft, Befehlshaber. Es war mir eine Ehre.	Denkar ni’Varra	9		
15.keep promise	Ich … halte mein Versprechen. Meine Männer tun dir nichts. Geh jetzt!	Salingian Commander	9		
15.humans	Sie schießen auf Verbündete, duellieren sich und lassen einen plötzlich gehen … ach, Menschen …	Ganthu	9		
15.respect honor	Etwas mehr Respekt vor der Ehre, Ganthu.	Denkar ni’Varra	9		
					
					
////////////////////////////////// Mission 1.6					
					
16.alarms 1	Hier ist es. Lasst die Wachen nicht Alarm schlagen, sonst ist der ganze Stützpunkt hinter uns her.	Denkar ni’Varra	1		
16.alarms 2	Die Schlitzer sind nicht clever genug, aber die Soldaten versuchen sicher, Alarm zu schlagen, wenn sie Eindringlinge sehen.	Denkar ni’Varra	1		
16.crowd control	Verstanden. Wenn wir auf Wachen treffen, müssen wir sie zu Eis erstarren lassen oder verwirren und sie dann erledigen, bevor sie zur Alarmstation laufen können.	Ganthu	1		
16.lets go	Okay, los geht’s!	Denkar ni’Varra	1		
					
16.got key	Eine Zugangskarte! Damit kann ich das Tor öffnen.	Denkar ni’Varra	2		
					
16.can sneak	So, wir sind drin. Wenn ich meinen Helm auflasse und Abstand halte, kann ich frei herumlaufen. Dich und Eji sollten die Wachen besser nicht sehen.	Denkar ni’Varra	3		
16.not too close	Gut, wir halten uns zurück, während du sie ablenkst.	Ganthu	3		
					
16.guards east	Meister Ganthu, östlich des Eingangs spüre ich viele Wachen.	Eji	4		
16.cant pass	Verstehe. Denkar, Eji und ich sollten den Durchgang im Osten meiden.	Ganthu	4		
					
16.kill guards	Diesen Wachtrupp können wir erledigen. Denkar, auf den Soldaten!	Ganthu	5		
					
16.too many	Hier sind zu viele Soldaten, Denkar. Nicht einmal du kannst dich an denen vorbeischleichen.	Ganthu	6		
16.diversion east	Wartet hier, ich versuch’s mit dem Durchgang im Osten. Vielleicht kann ich sie ablenken.	Denkar ni’Varra	6		
16.careful-16	Sei vorsichtig!	Ganthu	6		
					
16.found bombs	Hm, ein Xenolit-Lager. Ob es dort auch diese Sprengsätze gibt? Ich muss aufpassen, dass die Wachen nicht in der Nähe sind, wenn ich die Kisten durchsuche.	Denkar ni’Varra	7		
					
16.got bombs	Sehr gut! Die kann ich an einem Gebäude anbringen und aus der Ferne zünden. Dann gehen die Wachen bestimmt nachsehen, was los ist.	Denkar ni’Varra	8		
					
16.bomb spot	Hier kann man gut einen Sprengsatz anbringen. Ich muss nur aufpassen, dass die Wachen mich dabei nicht beobachten.	Denkar ni’Varra	9		
					
16.bomb planted	Die Sprengsätze sind angebracht!	Denkar ni’Varra	10		
					
16.boom1	Ich aktiviere die Sprengsätze!	Denkar ni’Varra	11		
					
16.boom2	Ich aktiviere die Sprengsätze!	Denkar ni’Varra	12		
					
16.boom3	Ich aktiviere die Sprengsätze!	Denkar ni’Varra	13		
					
16.heard boom	Da ist etwas explodiert! Wir müssen nachsehen, was los ist.	SalingOfficer	14		
					
16.another block	Wieder eine Sperre. Der Explosionstrick hat funktioniert; probieren wir’s damit noch einmal!	Denkar ni’Varra	15		
					
16.third block	Schon wieder eine Sperre.	Ganthu	16		
16.last one	Wir kommen näher. Das müsste die letzte sein. Wecken wir sie auf.	Denkar ni’Varra	16		
16.panic	Sie sind verwirrt, das spüre ich. Sie fallen bestimmt drauf rein.	Eji	16		
					
////////////////////////////////// Mission 2.1					
					
21.save village	Das Dorf wird angegriffen! Helfen wir den Verteidigern!	Ganthu	1		
21.save lab	Befehlshaber ni’Varra, wir haben klaren Befehl, die Forschungseinrichtung zu beschützen!	Kuna ni’Dahl	1		
21.save both	Vielleicht können wir den Befehl befolgen und gleichzeitig dem Dorf helfen.	Denkar ni’Varra	1		
21.enemy	Wir wissen von einer Ansammlung feindlicher Truppen auf halber Höhe zwischen Dorf und Labor sowie von einer unbekannten Einrichtung im Nordosten.	Kuna ni’Dahl	1		
					
21.kuna reinforcements	Wir halten nicht mehr lange durch! Ich rufe Verstärkung!	Kuna ni’Dahl	2		
					
21.kuna - where are the reinf	Lilly, wo ist die Verstärkung?	Kuna ni’Dahl	3		
21.lilly - i am afraid i am	Ich fürchte, ich bin die Verstärkung, Vollstreckerin ni’Dahl. Diese Kreaturen sind überall in der Stadt. All unsere Truppen sind im Einsatz.	Surgeon Lilly	3		
					
21.knew it	Ich wusste es!	Denkar ni’Varra	4		
					
21.whats this	Was <i>ist</> dieses hässliche Ding?!	Kuna ni’Dahl	5		
21.destroy it	Es scheint den Kreaturen wichtig zu sein. Schalten wir es aus!	Denkar ni’Varra	5		
					
					
////////////////////////////////// Mission 2.2					
					
22.score to settle	Die Varunianer verfolgen hier offenbar langfristige Pläne. Wir müssen uns durchschlagen. Aber ich habe sowieso noch eine Rechnung offen.	Denkar ni’Varra	1		
22.take it easy	Vorsicht, Denkar. Rache ist ein schlechter Ratgeber.	Ganthu	1		
					
22.looks hard	Hm, das wird nicht leicht.	Ganthu	2		
22.we can do it	Wir können uns wohl durch sie hindurchkämpfen.	Denkar ni’Varra	2		
22.casualties	Wahrscheinlich können wir das. Aber zu welchem Preis?	Ganthu	2		
22.not running	Wenn wir umsichtig kämpfen, schaffen wir es mit minimalen Verlusten. Ich verstecke mich nicht mehr!	Denkar ni’Varra	2		
22.clear judgement	Ich verstehe, wie du dich fühlst, aber lass das nicht dein Urteilsvermögen trüben.	Ganthu	2		
22.you right	Du hast recht.	Denkar ni’Varra	2		
					
22.assassins	Assassinen! Tötet sie!	Denkar ni’Varra	3		
					
22.found diary	Hier ist es. Das Tagebuch meines Vaters muss irgendwo bei der Ruine sein.	Denkar ni’Varra	4		
					
22.look east	Denkar! Im Osten!	Ganthu	5		
22.where came from	Was? Wo kommen die her?	Denkar ni’Varra	5		
22.coming our way	Die wichtigere Frage ist doch: Wo wollen sie hin? Und ich glaube, sie kommen hierher.	Ganthu	5		
22.consider running	Ich weiß, dass du dich nicht mehr weglaufen wolltest, aber ich glaube, das solltest du noch mal überdenken.	Ganthu	5		
22.lets run	Verdammt. Rückzug! Alle weg, los, los, los!	Denkar ni’Varra	5		
					
					
////////////////////////////////// Mission 2.3					
					
23.scout the area	Wir müssen das Gebiet auskundschaften, alte Ruinen suchen.	Arna ni’Varra	1		
23.careful-23	Vorsicht vor dem Stützpunkt, den wir vom Schiff aus entdeckt haben.	Denkar ni’Varra	1		
					
23.stay away from base	Dieser Eingang wird sehr gut bewacht. Halten wir uns besser vom Stützpunkt fern.	Denkar ni’Varra	2		
					
23.check this out	Bei den Ausgrabungen hier wurde etwas Großes gefunden. Erledige die Wachen und hol die Techniker. Sie sollen sich das ansehen.	Denkar ni’Varra	3		
23.need time	Die Untersuchung wird etwas dauern.	Technician, mission 23	3		
23.hurry-23	Beeilung, wir sitzen hier auf dem Präsentierteller.	Arna ni’Varra	3		
					
23.need power	Das war Teil eines großen Außenpostens. Alles ist gut erhalten. Wenn wir die Energiequelle finden und aktivieren, könnten wir sogar Informationen aus den Rechnern ziehen.	Technician, mission 23	4		
23.find power	Dann mal los. Wir suchen etwas, das wie eine Energiequelle aussieht.	Arna ni’Varra	4		
					
23.start generator	Das könnte eine Art Energiegenerator sein. Sieht intakt aus. Ob wir ihn aktivieren können?	Arna ni’Varra	5		
23.expect trouble	Aber Vorsicht! Die Maschinen lassen uns bestimmt nicht in Ruhe.	Denkar ni’Varra	5		
					
23.heal me	Huch! Ich habe eine Schutzvorrichtung aktiviert. Der Generator steht unter Starkstrom. Jemand muss mich während der Arbeit heilen, sonst überlebe ich keine 20 Sekunden!	Technician, mission 23	6		
					
23.generator online	Ja! Der Energiegenerator läuft!	Technician, mission 23	7		
23.go back	Wir müssen zurück und herausfinden, ob wir etwas aus den Rechnern ziehen können!	Arna ni’Varra	7		
					
23.path blocked	Achtung! Der Generator hat ein Abwehrfeld aktiviert! Zurück können wir nicht. Wir müssen andere Rechner finden.	Arna ni’Varra	8		
					
23.found another site	Toll, noch mehr Computer. Techniker, überprüfen Sie, ob die Rechner laufen!	Arna ni’Varra	9		
23.affirmative	Ja, wird gemacht!	Technician, mission 23	9		
23.no power	Die Rechner sind gut erhalten, aber wir brauchen Energie. Vielleicht finden wir die Energiequelle des Außenpostens.	Technician, mission 23	9		
					
23.got it	Die Computer funktionieren. Wir haben alles heruntergeladen.	Technician, mission 23	10		
23.go home	Sehr gut! Denkar, ich will hier schnellstmöglich raus. Die Bots, die uns angreifen, sind mir unheimlich.	Arna ni’Varra	10		
					
23.victory-23	Wir sind hier fertig. Ruf die Transporter.	Arna ni’Varra	11		
					
23.technicians are dead	Die Techniker sind tot. Unsere Expedition ist gescheitert.	Arna ni’Varra	12		
					
					
////////////////////////////////// Mission 2.4					
					
24.nasty bugs	Was für fiese Biester ... Wo sind die bloß hergekommen?!	Denkar ni’Varra	1		
24.expect more bugs	Das werden wir sicher sehr bald herausfinden.	Arna ni’Varra	1		
					
24.too hard	Es wird immer schlimmer. Ich weiß nicht, ob wir mit mehr von denen fertig werden.	Denkar ni’Varra	2		
24.have faith	Ich glaube, wir sind nicht alleine hier. Vielleicht finden wir irgendwo Hilfe.	Ganthu	2		
					
24.what the	Wo <i>sind</> wir hier?	Arna ni’Varra	3		
24.nesting place	Hm, interessant. Ob dieses Artefakt der Grund dafür ist, dass die Viecher hier nisten?	Ganthu	3		
24.clear nest	So oder so müssen wir das Nest vernichten, um weiter zu kommen.	Denkar ni’Varra	3		
24.check artifact	Wir sollten auch das Artefakt untersuchen.	Arna ni’Varra	3		
					
24.kill bugs	Hüllt sie in Flammen!	Umbagu High Priest	4		
24.must help	Denkar, wir müssen ihnen helfen!	Ganthu	4		
					
24.village attacked	Vielen Dank für eure Hilfe, Fremde. Die Brut der Plage greift unser Dorf aus allen Richtungen an!	Umbagu High Priest	5		x
24.join forces	Wir müssen uns ohnehin zu ihnen durchschlagen. Tun wir uns zusammen.	Denkar ni’Varra	5		
					
24.you saved us	Nochmals danke! Ihr habt uns gerettet! Aber was führt euch zu diesem Ort, Menschen und Mutanten vereint?	Umbagu High Priest	6		
24.we seek ruins	Wir suchen nach alten Ruinen, die hier irgendwo in der Gegend sein müssen.	Arna ni’Varra	5		
24.beware monster	Wenn ihr diesem Weg folgt, kommt ihr zu einem alten Tunneleingang. Aber ein gefährliches Monster lebt dort. Es befehligt diese Kreaturen.	Umbagu High Priest	6		
24.we face monster	Dann müssen wir uns wohl um dieses Monster kümmern.	Denkar ni’Varra	6		
24.offer reinforcements	Nehmt diese Untiere als Zeichen unserer Dankbarkeit. Sie sind wild, aber treu.	Umbagu High Priest	6		
24.thanks for reinforcements	Vielen Dank!	Ganthu	6		
					
24.priest dead	Der Hohepriester ist tot ... Verschwinden wir, bevor sie uns das anhängen!	Denkar ni’Varra	7		
					
24.giant spider	Der Eingang zum unterirdischen Komplex ist hinter dem Monster. Wir müssen es besiegen, um einzutreten!	Denkar ni’Varra	8		
					
					
////////////////////////////////// Mission 2.5					
					
25.be careful-25	Wir müssen äußerst vorsichtig sein. Es gab schon viele Expeditionen in die Stadt. Keine davon kam je zurück.	Denkar ni’Varra	1		
25.suspect everything	Alles kann eine Gefahr darstellen, auch Dinge, die ganz harmlos aussehen!	Denkar ni’Varra	1		
					
25.esperanza gates	Da! Das muss ein Zugang zum Stadtinneren sein!	Ganthu	2		
25.esperanza forcefield	Unglaublich, er wird immer noch von einem Kraftfeld geschützt. Wir müssen es deaktivieren.	Denkar ni’Varra	2		
25.saw a device	Ich glaube, wir sind vorhin an einem Gerät vorbeigekommen.	Ganthu	2		
					
25.mechanism	Hm ... Ich frage mich, was das steuert.	Denkar ni’Varra	3		
					
25.power source	Sieht nach einer Energiequelle aus. Vielleicht versorgt sie das Kraftfeld.	Denkar ni’Varra	4		
25.we should try	Tja, das finden wir nur auf eine Art heraus.	Ganthu	4		
					
25.forcefield down	Das Kraftfeld ist deaktiviert!	Denkar ni’Varra	5		
25.controls outside	Sehr seltsam, dass die Barriere von außen gesteuert werden kann.	Eji	5		
25.keep smth in	Vielleicht sollte sie nicht uns aus-, sondern etwas anderes einsperren?	Denkar ni’Varra	5		
25.spooky	Das klingt unheimlich.	Eji	5		
					
25.rain comment 1	Na toll. Horden unheimlicher Wesen <i>und</> strömender Regen.	Denkar ni’Varra	6		
25.rain comment 2	Hoffentlich gefällt ihnen das Wetter genau so wenig wie uns.	Ganthu	6		
					
25.protect gates	Beschützt das Tor! Die wollen unbedingt hier rein!	Denkar ni’Varra	7		
					
25.no more aliens	Hm, sie wollen uns wohl vorerst in Ruhe lassen.	Denkar ni’Varra	8		
25.strange	An dieser Ruhe stimmt etwas nicht. Vielleicht haben sie sich nur auf uns eingestellt.	Ganthu	8		
25.faint song	Moment ... Ich spüre etwas aus Richtung des Eingangs. Wie ein leises Lied in meinem Kopf.	Eji	8		
25.prophecy	Das Lied aus der Prophezeiung? Kannst du ihm folgen?	Ganthu	8		
25.can follow	Ich glaube schon.	Eji	8		
25.enter	Gehen wir rein! Lüften wir das Geheimnis dieses Ortes!	Denkar ni’Varra	8		
					
25.generator restarted	Verdammt ... Es ist neu gestartet. Man muss wohl noch etwas ausschalten.	Denkar ni’Varra	9		
					
					
////////////////////////////////// Mission 2.6					
					
26.song north	Das Lied kommt von hinter dem Tor im Norden!	Eji	1		
26.go north	Also nach Norden.	Ganthu	1		
26.trouble ahead	Riecht nach Schwierigkeiten. Seid vorsichtig!	Denkar ni’Varra	1		
					
26.transport device	Versuchen wir, das Gerät für den Transport vom Podest abzubauen.	Denkar ni’Varra	2		
26.be careful-26	Vorsicht, da könnten noch mehr Fallen sein!	Ganthu	2		
26.what was that	Halt! Was war das?	Denkar ni’Varra	2		
26.someone coming	Vorsicht! Ich fühle, dass sich viele Feinde nähern!	Eji	2		
					
26.robot awake	Das ist nicht gut! Der „tote“ Mech wacht auf!	Denkar ni’Varra	3		
					
26.gates opened	Geschafft! Ich glaube, die Tore sind offen.	Denkar ni’Varra	4		
					
26.switch operated	Geschafft! Ich weiß nur nicht genau, was eigentlich.	Denkar ni’Varra	5		
26.we will see	Gehen wir weiter und finden es heraus.	Ganthu	5		
					
26.a trap	Hey! Hier sind überall Fallen!	Denkar ni’Varra	6		
26.only one trap	Wir haben nur eine Falle ausgelöst. Hoffentlich war es die einzige.	Ganthu	6		
26.detour	Auf jeden Fall ist das Tor verschlossen. Wir brauchen einen anderen Weg.	Denkar ni’Varra	6		
					
26.second trap	Eine zweite Falle! Wir müssen vorsichtiger sein.	Denkar ni’Varra	7		
26.why traps	Wer stellt denn in einer Ruine Fallen auf?	Ganthu	7		
26.guess about traps	Vielleicht sind es aber auch keine Fallen, sondern Maschinen mit Fehlfunktion. Wer weiß, welche Technik und Magie hier benutzt wurde?	Denkar ni’Varra	7		
					
26.third trap	Und da die Nächste!	Denkar ni’Varra	8		
26.spot traps	Vielleicht kann man diese Dinger im Voraus entdecken.	Ganthu	8		
26.activate traps	Ich geh voran und löse sie aus, weil ich am stärksten gepanzert bin.	Denkar ni’Varra	8		
					
26.control room	Sieht wie ein Kontrollraum aus ... mit einem riesigen Mech darin.	Denkar ni’Varra	9		
26.it is dead	Anscheinend ist er seit Jahrhunderten tot.	Ganthu	9		
26.i wouldnt bet	Darauf würde ich nicht wetten.	Denkar ni’Varra	9		
					
26.getting closer	Wir sind nah dran. Das Lied ist hier lauter.	Eji	10		
26.open gate	Wir müssen irgendwie dieses Tor aufkriegen!	Ganthu	10		
					
26.aliens	He, diese grünen Männchen verfolgen uns!	Denkar ni’Varra	11		
26.hurry-26	Los, Beeilung!	Ganthu	11		
26.look for traps	Verdammt! Wenn wir noch schneller laufen, lösen wir hier alle Fallen aus!	Denkar ni’Varra	11		
					
26.the source	Das ist es! Von hier kommt das Lied!	Eji	12		
					
26.aliens2	Vorsicht, Denkar! Grüne-Männchen-Alarm!	Ganthu	13		
26.kill them all	Schützt das Gerät!	Denkar ni’Varra	13		
					
////////////////////////////////// Mission 3.1					
					
31.doomed	Der Psi-Resonator wurde zerstört! Wir sind verloren ...	Denkar ni’Varra	1		
					
31.resonator alone	Hey, um es zurück zu lassen, ist das Ding viel zu wertvoll!	Denkar ni’Varra	2		
					
31.ship to the east	Tharksh vermutet sein Schiff östlich von hier.	Tharksh	3		
31.protect the resonator	Gut, gehen wir zum Schiff. Tharkshs Schergen müssen den Psi-Resonator um jeden Preis schützen.	Denkar ni’Varra	3		
					
31.blown cover	Tharksh glaubt, unsere Tarnung ist gerade beeinträchtigt worden. Er sollte das Gerät zerstören, also missachtet er jetzt offen die Befehle des Erzmeisters.	Tharksh	4		
31.another master	Also ist hier noch mindestens ein anderer Meister, und das waren seine Schergen?	Denkar ni’Varra	4		
31.right	Tharksh glaubt, du hast recht.	Tharksh	4		
					
31.aliens detected	Tharksh hat vor uns einen weiteren Alien-Meister entdeckt!	Tharksh	5		
31.how many	Nur einen Meister oder auch Schergen?	Denkar ni’Varra	5		
31.many	Tharksh sieht eine ganze Sturmeinheit.	Tharksh	5		
31.call reinforcements	Kann Tharksh seine Schergen kontaktieren?	Denkar ni’Varra	5		
31.reinforcements called	Tharksh fordert Verstärkung an. Sie werden unerkannt durchkommen.	Tharksh	5		
31.hold the line	Gut. Dann müssen wir nur durchhalten, bis sie nahe genug sind.	Denkar ni’Varra	5		
					
31.elephant worms	Hey, wieder diese Dinger mit den explodierenden Sporen. Sie wachsen direkt aus der Wand.	Denkar ni’Varra	6		
					
31.tough aliens	Tharksh, deine Art ist zäh.	Denkar ni’Varra	7		
31.glad to hear that	Tharksh freut sich, das zu hören.	Tharksh	7		
31.other ship	Tharksh kann dieses Schiff nicht benutzen. Ihm fehlen die Steuerungscodes.	Tharksh	7		
31.lets continue	Gehen wir also zu seinem Schiff.	Denkar ni’Varra	7		
					
31.master ambush	Tharksh kennt diesen Meister. Er ist sein Rivale im Schwarm und war schon vorher gegen ihn.	Tharksh	8		
31.no problem	Hm, eine seltsame Möglichkeit für sie, offene Rechnungen zu begleichen ...	Denkar ni’Varra	8		
					
31.lets get out of here	Wir sollten verschwinden, bevor noch mehr Aliens auftauchen!	Denkar ni’Varra	9		
31.ok	Tharksh drängt dich, an Bord zu gehen.	Tharksh	9		
					
////////////////////////////////// Mission 3.2					
					
32.protect ship	Macht euch sofort kampfbereit! Beschützt das Schiff, der Psi-Resonator ist noch drin!	Denkar ni’Varra	1		
					
32.is this your best	Mehr habt ihr nicht drauf, ihr hässlichen Viecher?	Denkar ni’Varra	2		
32.alien roar	...!	Tharksh	2		
32.oops	Tut mir leid, Tharksh.	Denkar ni’Varra	2		
					
32.waves over	Mehr konnten sie wohl nicht ausrichten ... vorerst.	Denkar ni’Varra	3		
32.base nearby	Tharksh glaubt, dass ein Lager in der Nähe ist. Um die Gegend zu sichern, sollten wir es räumen.	Tharksh	3		
					
32.avoid gas	Moment! Tharksh spürt Gefahr. Wir müssen dieses Gas meiden.	Tharksh	4		
32.stop gas	Diese Kreaturen haben wohl etwas mit dem Gas zu tun. Irgendwie muss man es stoppen können.	Denkar ni’Varra	4		
					
32.safe	Mehr können wir wohl nicht tun. Gehen wir durch und beten!	Denkar ni’Varra	5		
					
32.found base	Das muss das Lager sein. Räumen wir auf hier!	Denkar ni’Varra	6		
					
32.resonator alone	Hey, um es zurück zu lassen, ist das Ding zu wertvoll!	Denkar ni’Varra	7		
					
32.doomed	Der Psi-Resonator wurde zerstört! Wir sind verloren ...	Denkar ni’Varra	8		
					
////////////////////////////////// Mission 3.3					
					
33.defences coming	Ein Angriff steht bevor! Aurora schickt uns Geschütztürme. Beschützt das Schiff, sonst können wir das Teleportationssignal nicht verstärken!	Kuna ni’Dahl	1		
					
33.help	Wir sind umzingelt! Hilfe!	High Priest, mission 33	2		
					
33.thanks for help	Danke für eure Hilfe, Menschen! Diese Dinger hatten uns überfallen und in die Sümpfe getrieben. Nehmt diese Bestien und Unterweltwesen zum Dank. Sie werden für euch kämpfen!	High Priest, mission 33	3		
33.gift welcome	Vielen Dank für die Gabe.	Arna ni’Varra	3		
					
33.sensors misbehaving	Hey, meine Sensoren spielen verrückt!	Arna ni’Varra	4		
33.found site	Das muss die Flugabwehrstellung sein. Zerstören wir das Ding und hauen ab!	Kuna ni’Dahl	4		
					
33.turret1 online	Erster Geschützturm ist aktiviert!	Kuna ni’Dahl	5		
					
33.turret2 online	Zweiter Geschützturm bereit! Die Hälfte ist geschafft!	Kuna ni’Dahl	6		
					
33.turret3 online	Dritter Geschützturm aktiv! Es fehlt nur noch einer!	Kuna ni’Dahl	7		
					
33.turret4 online	Die Geschütztürme sind jetzt in Betrieb! Das Schiff ist gut geschützt. Jetzt sollten wir herausfinden, was uns aus der Luft geholt hat, und es beseitigen!	Kuna ni’Dahl	8		
					
33.victory-33	Wir sind hier fertig. Transporter verständigen!	Kuna ni’Dahl	9		
33.help denkar	Helfen wir jetzt Denkar!	Arna ni’Varra	9		
					
33.gonna blow	Zurück! Hier gibt’s gleich eine Explosion!	Kuna ni’Dahl	10		
					
					
////////////////////////////////// Mission 3.4					
					
34.follow the path	Weiter! Wir müssen weg von der Absturzstelle in Richtung Suchtrupp.	Denkar ni’Varra	1		
					
34.judge 1 sees enemy	Hauptquartier, Aliens in Sicht! Erbitte Erlaubnis zum Angriff!	Judge Davidov	2		
34.me friend	Wartet! Wir sind keine Feinde! Ich bin ein Mensch!	Denkar ni’Varra	2		
34.you enemy	Jetzt haben sie gelernt, uns zu imitieren! Tötet das Ding, schnell!	Judge Davidov	2		
34.fight inevitable	Tharksh glaubt nicht, dass sie dir zuhören werden.	Tharksh	2		
34.self defend	Wir haben keine Wahl. Wir müssen uns verteidigen!	Denkar ni’Varra	2		
					
34.judge 2 sees enemy	Hauptquartier, Feind gesichtet! Erbitte Verteidigungsmaßnahmen!	Judge Smirnov	3		
34.turrets coming	Achtung! Sie teleportieren Geschütztürme!	Denkar ni’Varra	3		
34.handle turrets	Tharksh findet, wir sollten sie ihre Abwehr nicht aufstellen lassen.	Tharksh	3		
34.turrets advise	Zerstören wir die Teleportationsfelder, bevor die Geschütztürme kommen!	Denkar ni’Varra	3		
					
34.judge 3 sees enemy	Erledigt die hässlichen Viecher! Keiner weicht zurück!	Absolute Judge	4		
					
34.stop right there	Es reicht jetzt! Hey! Weg von diesen Kreaturen!	Vasilii	5		
34.no fight	Glaub uns, wir wollen nicht kämpfen. Ihr habt uns angegriffen.	Denkar ni’Varra	5		
34.lay your weapons	Nein, diese Kreaturen haben unsere Expeditionen zuerst angegriffen! Legt eure Waffen ab und entfernt euch von dem Gerät!	Vasilii	5		
34.wont happen	Lasst uns durch, oder wir wenden Gewalt an!	Denkar ni’Varra	5		
34.hard way	Also gut. Dann wendet Gewalt an.	Vasilii	5		
					
34.switch	Hier ist ein Bedienfeld. Ich deaktiviere die übrigen Geschütze.	Denkar ni’Varra	6		
34.hurry-34	Tharksh glaubt, Eile ist geboten.	Tharksh	6		
					
34.switch done	Die Geschütztürme sind deaktiviert!	Denkar ni’Varra	7		
					
34.hunters killed	Diese „Tarnung“ wird immer gefährlicher für uns. Jetzt greift uns <i>jeder</> sofort an!	Denkar ni’Varra	8		
					
34.stop or i kill you	Halt! Wer da? Warum helft ihr diesen Höllenkreaturen?	High Priest, mission 34	9		
34.i mean no harm	Wir wollen nicht Böses! Unsere Reise nach Osten führt uns hier durch.	Denkar ni’Varra	9		
34.you murderer	Das Blut meines Volkes klebt an deinen Händen! Das wirst du büßen, Lügner!	High Priest, mission 34	9		
34.destroy temple	Zerstört den Tempel! Das wird sie aufhalten!	Denkar ni’Varra	9		
					
34.sorry ganthu	Es tut mir leid, Ganthu. Wir hatten keine Wahl.	Denkar ni’Varra	10		
					
34.humans fight mutants	Hier tobt ein Kampf! Und die Mutanten scheinen ihn zu verlieren.	Denkar ni’Varra	11		
34.they will attack us	Tharksh findet, wir sollten sie unterstützen. So bleibt keiner übrig, der uns bekämpft.	Tharksh	11		
34.we wait-34	Oder wir warten das Ende des Kampfes ab. Dann greifen wir den Sieger an.	Denkar ni’Varra	11		
					
34.transmission	Wir empfangen eine Übertragung!	Denkar ni’Varra	12		
34.hi guys	Hey, Leute! Wir holen euch ab! Wir haben eure Position. Bleibt einfach, wo ihr seid!	Kuna ni’Dahl	12		
34.get us out	Schön, von dir zu hören! Hier unten herrscht Chaos! Jeder kämpft gegen jeden, und ständig greifen uns alle an!	Denkar ni’Varra	12		
34.secure the lz	Sichert einfach nur die Landezone!	Kuna ni’Dahl	12		
					
34.arriving	Erreichen Landezone, Evakuierung vorbereiten!	Kuna ni’Dahl	13		
34.who are these	Was zum ...! Ganthu, hat Tharksh die beschworen?	Denkar ni’Varra	13		
34.tharksh puzzled	Tharksh ist genauso verwirrt wie ich!	Tharksh	13		
34.they stole the resonator	Verdammt, sie haben den Psi-Resonator!	Denkar ni’Varra	13		
34.we must hurry	Beeilung, Leute! Wir müssen schnell weg hier!	Kuna ni’Dahl	13		
					
34.doomed	Der Psi-Resonator wurde zerstört! Wir sind verloren ...	Denkar ni’Varra	14		
					
34.resonator alone	Hey, das Ding ist viel zu kostbar, um es allein zu lassen!	Denkar ni’Varra	15		
					
////////////////////////////////// Mission 3.5					
					
35.is it a teleporter	Die Jaar Lash sind direkt da raus gekommen. Ist es ein Teleporter?	Denkar ni’Varra	1		
35.disable spawner 1	Ja. Tharksh kann ihn deaktivieren, damit keine Verstärkung nachkommt.	Tharksh	1		
35.can we use it	Können wir ihn nicht selbst verwenden?	Denkar ni’Varra	1		
35.receiver only	Es ist nur ein Empfänger. Außerdem würde er uns direkt zur Quelle der Verstärkung bringen.	Tharksh	1		
					
35.spawner 1 disabled	Tharksh ist bereit.	Tharksh	2		
					
35.disable spawner 2	Noch ein Teleporter. Ich glaube, wir haben ihre erste Verteidigungslinie erwischt.	Kuna ni’Dahl	3		
					
35.spawner 2 disabled	Von hier aus geht kein Alien mehr auf Reisen.	Denkar ni’Varra	4		
					
35.disable spawner 3	Noch eins von den Dingern. Wir dürfen uns nicht mit ihnen aufhalten.	Arna ni’Varra	5		
35.cant leave them	Wir können es nicht zu lassen, dass ständig diese Wesen hinter uns auftauchen.	Denkar ni’Varra	5		
					
35.spawner 3 disabled	Der Empfänger ist deaktiviert.	Tharksh	6		
35.not funny	Hoffentlich haben wir alle gefunden.	Arna ni’Varra	6		
					
35.disable spawner 4	Diese Teleporter scheinen überall zu sein!	Denkar ni’Varra	7		
35.this is the last	Der hier könnte der letzte sein. Das scheint eine Art Kontrollpunkt zu sein.	Kuna ni’Dahl	7		
					
35.describe situation	Hier ist ein Teleportationsfeld, aber die Steuerung ist irgendwo hinter dem Schild. Nur Jaar Lash können durch den Schild gehen.	Tharksh	8		
35.we have a plan	Es gibt nur eine Möglichkeit: Tharksh muss rein, die Steuerung finden und uns hineinteleportieren.	Denkar ni’Varra	8		
35.jaar lash units	Tharksh kann Jaar-Lash-Einheiten mitnehmen.	Tharksh	8		
35.we wait-35	Warten wir einfach ab, wer am Ende siegt. Das ist unser Gegner.	Denkar ni’Varra	8		
35.dont like	Es gefällt mir nicht, dass wir uns jetzt aufteilen.	Kuna ni’Dahl	8		
35.no choice	Uns bleibt aber keine Wahl.	Denkar ni’Varra	8		
					
35.teleporter controls	Tharksh glaubt, dass das die Steuerung des Teleporters ist. Um ihn zu aktivieren, muss er am Leben sein!	Tharksh	9		
					
35.disable spawner 5	Wir sollten keinen aktiven Teleporter zurücklassen!	Denkar ni’Varra	10		
35.fast enough	Tharksh wird ihn schon rechtzeitig deaktivieren.	Tharksh	10		
					
35.dead end	Eine Sackgasse!	Denkar ni’Varra	11		
35.enable teleporter	Hier ist ein Teleporter, aber wir müssen erst die Verteidigung eliminieren, um die Steuerung zu erreichen.	Tharksh	11		
					
					
////////////////////////////////// Mission 3.6					
					
36.do you sense	Eji, sind wir auf dem richtigen Weg? Spürst du den Psi-Resonator?	Denkar ni’Varra	1		
36.too far	Ja, die Richtung stimmt. Ich höre das Lied, aber die Maschine ist zu weit weg.	Eji	1		
36.find spot	Dann müssen wir weiter, bis wir nah genug sind.	Denkar ni’Varra	1		
					
36.found spot	Ich bin nah genug dran. Das Alien singt bereits zur Scherbe! Beeilen wir uns!	Eji	2		
36.get him	Das ist allein dein Kampf, Eji. Helfen können wir dir nicht, aber wir beschützen dich mit aller Kraft!	Denkar ni’Varra	2		
36.concentration	Sein Geist ist ... sehr stark. Ich muss mich konzentrieren.	Eji	2		
36.guard eji	Die Verbindung mit dem Resonator scheint Ejis Körper zu schützen. Wir sollten sie dennoch vor Angriffen bewahren, um ihre Konzentration nicht zu stören.	Arna ni’Varra	2		
36.attack alien	Es wäre wohl auch gut, ihren Spiritisten zu finden, anzugreifen und <i>seine</> Konzentration zu stören.	Kuna ni’Dahl	2		
					
36.it is done	Es ist vollbracht.	Eji	3		
36.shard changing	Schaut! Die Scherbe verändert sich!	Arna ni’Varra	3		
					
36.too strong	Er ist zu stark ... Kann ihn ... nicht ... halten ...	Eji	4		
36.eji no	Eji! Nein!	Denkar ni’Varra	4		
					
////////////////////////////////// Special Location BSA					
					
bsa.greetings	Meine Damen und Herren, der große Preis der Kampfsportarena von Saling!	Announcer	1		
					
bsa.enter arena	Kandidaten, macht euch kampfbereit und betretet die Arena!	Announcer	2		
					
bsa.yamu coming	Jetzt erlebt ihr die Wut des mächtigen Kampf-Yamu!	Announcer	3		
					
bsa.horror coming	Erzittert vor den Zorn des Reptils!	Announcer	4		
					
bsa.wave1	Die Bestie ist besiegt! Doch sie war ein einzelner, großer, dummer Gegner! Sehen wir, wie ihr euch gegen geübte Krieger schlagt!	Announcer	5		
					
bsa.wave2	Jetzt bringen wir ein paar klingen- und raketenbewehrte Maschinen ins Spiel!	Announcer	6		
					
bsa.wave3	Wow! Ihr macht echte Fortschritte! Doch wir sind unfair und setzen euch alles entgegen, was wir haben – auch die Offiziere!	Announcer	7		
					
bsa.wave4	Pah ... das reicht jetzt – bringt die Höllenfeuer!	Announcer	8		
					
bsa.clear arena	Kandidaten, verlasst die Arena!	Announcer	9		
					
bsa.warning1	Warnung, Kandidaten! Verlasst sofort die Arena!	Announcer	10		
					
bsa.warning2	Zweite Warnung: Wenn ihr die Arena nicht verlasst, feuern wir!	Announcer	11		
					
bsa.kill them	Okay, Leute! Macht kurzen Prozess!	Announcer	12		
					
					
////////////////////////////////// Special Location ROM					
					
rom.intruders	Da sind Eindringlinge! Aktiviert mein Schiff!	HF1337	1		
rom.hurry-rom	Wir wurden entdeckt! Wir müssen uns beeilen!	Leader	1		
					
rom.shuttle arrived	Mein Schiff ist da! Sprengt die Korridore!	HF1337	2		
					
rom.boss seen	Ich habe ein schlechtes Gefühl dabei.	Leader	3		
					
rom.cancel shuttle	Vergesst das Schiff! Ich kümmere mich selbst um die Eindringlinge!	HF1337	4		
					
rom.activate cannon	Diese Hülle brauche ich nicht mehr! Aktiviert das Geschütz!	HF1337	5		
rom.deactivate cannon	Na toll. Jetzt müssen wir das Geschütz deaktivieren!	Leader	5		
					
rom.reinforcements	Wir haben ein Teleportationssignal und können Verstärkung ordern!	Leader	6		
					
					
////////////////////////////////// Special Location Junkyard					
					
junkyard.intruders	Eindringlinge entdeckt! Bringt alle Wertsachen in Sicherheit!	Trashmaster Ditz	1		
junkyard.hurry-junkyard	Schneller! Sehen wir, was die Blechdosen verstecken wollen!	Leader	1		
					
junkyard.ported on time	Erledigt! Folgt mir, ich sehe etwas Großes am Strand.	Leader	2		
					
junkyard.late with port	Verdammt, wir kommen zu spät! Sie haben alles versteckt!	Leader	3		
					
junkyard.kirxxa dead	Kirxxa! Das werdet ihr bereuen, Eindringlinge!	Trashmaster Ditz	4		
					
junkyard.gorgar will eat you	Gorgar verschlingt euch!	Trashmaster Ditz	5		
					
junkyard.gorgar dead	Gorgar ist besiegt! Die Sache gerät außer Kontrolle!	Trashmaster Ditz	6		
					
junkyard.coming	Das ist eure letzte Chance, umzukehren. Ich werde euch jagen!	Trashmaster Ditz	7		
					
junkyard.call technicians	Techniker, aktiviert alle Botfabriken!	Trashmaster Ditz	8		
					
junkyard.a-bot wave	Ich brauche Verstärkung!	Trashmaster Ditz	9		
					
junkyard.nomad wave	Sekundärverstärkung, Angriff!	Trashmaster Ditz	10		
					
junkyard.machines wave	Alle Notfall-Verstärkungen aktivieren!	Trashmaster Ditz	11		
					
junkyard.ditz dies no xessk	Prozesse werden beendet ...	Trashmaster Ditz	12		
					
junkyard.ditz dies xessk spawns	Entfesselt Xessk, lasst ihn Kirxxa rächen! Prozesse werden beendet ...	Trashmaster Ditz	13		
					
					
////////////////////////////////// Special Location DTB					
					
dtb.lets move	Vorsichtig vorgehen!	Leader	1		
					
dtb.at cages	Käfige! Wir sollten auf alles gefasst sein, wenn wir sie öffnen.	Leader	2		
					
dtb.cages done	Es müsste bald vorbei sein.	Leader	3		
					
dtb.at adam	Arme Kreatur. Erlösen wir sie von ihrer Qual!	Leader	4		
					
dtb.got company	Vater, wir haben Gesellschaft!	Adam	4a		
dtb.entertain guests	Kümmerst du dich bitte um unsere Gäste, Adam?	Frank N. Stein	4a		
dtb.come to adam	Hehe … ja, Vater! Kommt, Gäste, spielen wir!	Adam	4a		
					
dtb.you killed frank	Mörder meines Vaters! Ich will Rache!	Adam	4b		
					
dtb.adam dead	Dein Leid soll enden, arme Kreatur.	Leader	5		
dtb.you killed adam	Mörder! Was hat euch mein Adam getan? Kommt, ich warte auf euch!	Frank N. Stein	5a		
					
dtb.at frank	Wir haben ihren Commander. Erledigen wir ihn!	Leader	6		
					
dtb.adam watch me	Du forderst mich heraus? Adam! Sieh, wie ich diese Narren vernichte!	Frank N. Stein	7a		
					
dtb.revenge for adam	Das war dein letzter Fehler. Die Zeit ist gekommen, um Adam zu rächen!	Frank N. Stein	7b		
					
dtb.frank dead	Gut gemacht! Die Welt ist gerade etwas besser geworden.	Leader	8		
dtb.come try me	Für wen haltet ihr euch?! Das lasse ich nicht zu! Stellt euch mir, wenn ihr den Mut dazu habt!	Boss Hologram	8		
dtb.will come	Kann man so eine Einladung ablehnen? Wir freuen uns schon auf dich, du Schönheit!	Leader	8		
					
					
////////////////////////////////// Special Location Safari					
					
safari.explore	Haltet die Augen offen! Der kleinste Fehler kann euch das Leben kosten.	Leader	1		
					
safari.kill queen	Das nenn ich fette Beute. Erledigen wir sie!	Leader	2		
					
safari.killed queen	Ein ruhmreicher Erfolg!	Leader	3		
					
safari.kill mech0	Es ist nur eine Maschine! Vernichten wir sie!	Leader	4		
					
safari.killed mech0	Und das war’s!	Leader	5		
					
safari.jack in combat	Jetzt werden die Jäger zu Gejagten!	Jack the Crank	6		
					
safari.jack dead	Unmöglich! Ich bin besiegt! So sei es. Die Türen zu Bill stehen offen. Fordert ihn heraus, wenn ihr es wagt!	Jack the Crank	7		
					
safari.at bill	Das letzte Gefecht! Wir schaffen das!	Leader	8		
					
safari.bill in combat	Noch mehr mutige Jäger zum Vernichten! Dann vernichte ich sie!	Bill	9		
					
safari.bill dead	Aaaaah, nein!	Bill	10		
					
					
////////////////////////////////// Special Location Kharum					
					
kharum.help village	Die Dorfbewohner könnten Hilfe gebrauchen. Gehen wir!	Leader	1		
					
kharum.nomad wave	Ein Glück, dass ihr da seit. Bitte helft uns! Wir rechnen mit einem schweren Angriff.	Kharum Priest	2		
					
kharum.nomad wave dead	Dank euch leben wir noch! Zumindest vorerst. Können wir euch noch einmal um Hilfe bitten?	Kharum Priest	3		
					
kharum.retaliate	Diese Angriffe müssen ein für alle Mal aufhören! Findet heraus, woher sie kommen, und bereitet ihnen ein Ende!	Kharum Priest	4		
					
kharum.retaliated	Geschafft! Sagen wir den Dorfbewohnern, dass sie wieder ruhig schlafen können.	Leader	5		
					
kharum.talk to ran boo	Gute Arbeit! Jetzt bleibt nur noch ein Feind, den es zu besiegen gilt. Bitte sprich mit unserem Gast Ran Boo, er kann dir mehr darüber sagen.	Kharum Priest	6		
					
kharum.ran boo spawned	Du bist also hinter dem großen Roboter her? Wenn du zu ihm willst, müssen wir das alte Gerät im Dorf aktivieren. Aber es wird nicht leicht! Sag Bescheid, wenn’s losgehen kann.	Ran Boo	7		
					
kharum.lets go	Du hast Mut, das muss ich dir lassen. Jetzt müssen wir die Energiequellen in der Einöde finden und sie aktivieren. Du gehst voran.	Ran Boo	8		
					
kharum.found power source	Hier ist eine Energiequelle. Überlass das mir.	Ran Boo	9		
					
kharum.last power source	Jetzt haben wir genug Energie. Gehen wir ins Dorf und aktivieren das Gerät.	Ran Boo	10		
					
kharum.activating ancient device	Tritt zurück, ich schalte es jetzt an!	Ran Boo	11		
					
kharum.ancient device activated	Es klappt wirklich! Nicht, dass ich das bezweifelt hätte ... egal. Dann auf zum großen Blechburschen. Nach dir!	Ran Boo	12		
					
kharum.i kill you	So viel Mühe, um hier von mir vernichtet zu werden?! Es ist mir ein Vergnügen, diesen Wunsch zu erfüllen.	Trashmaster Ulv	13		
