sid	text:de
		
// 11		
obj.Clear the way	Machen Sie den Weg frei!
obj.Eliminate the hostile creatures	Eliminieren Sie die feindlichen Kreaturen!
obj.Save Denkar	Retten Sie Denkar!
obj.Avoid the patrols	Weichen Sie den Patrouillen aus!
		
// 12		
obj.Get help	Holen Sie Hilfe!
obj.Helpers:	Versammelte Verstärkung:
obj.Help the village	Erreichen Sie das Dorf!
obj.Defenders alive:	Überlebende Verteidiger:
obj.Clear the enemy camp	Besiegen Sie das ganze feindliche Lager!
obj.Enemies left:	Verbliebene Feinde:
		
// 13		
obj.Protect the xenolite	Beschützen Sie das Xenolit!
obj.Defenders alive:	Überlebende Verteidiger:
obj.Sneak in the camp	Schleichen Sie sich zum Lager!
obj.Return to the village	Kehren Sie zum Dorf zurück!
obj.Save Eji	Retten Sie Eji!
obj.Village defenders alive	Überlebende Dorfverteidiger:
obj.Escape the village	Fliehen Sie aus dem Dorf!
		
// 14		
obj.Enter the camp	Betreten Sie das Lager!
obj.Find escape vehicle	Finden Sie ein Fluchtfahrzeug!
obj.Eliminate the mine defenders	Beseitigen Sie die Minenwachposten!
		
// 15		
obj.Approach Saling	Nähern Sie sich Saling!
obj.Find your way to Saling	Finden Sie einen Weg nach Saling!
obj.Make your way past the camp	Gelangen Sie zur anderen Seite des Lagers!
obj.Defeat the Salingian Commander	Bezwingen Sie den Saling-Commander!
obj.Continue to Saling	Gehen Sie weiter nach Saling!
obj.Avoid the fire bursts	Weichen Sie den Feuerstößen aus!
		
// 16		
obj.Enter the base	Dringen Sie in den Stützpunkt ein!
obj.Remove the guards from the road	Beseitigen Sie die Wachen!
obj.Sneak through the base	Schleichen Sie durch den Stützpunkt!
obj.Reach the service entrance	Erreichen Sie den Diensteingang!
		
// 21		
obj.Protect the village	Beschützen Sie das Dorf!
obj.Defenders alive:	Überlebende Verteidiger:
obj.Protect the lab	Beschützen Sie das Labor!
obj.Turrets left:	Verbliebene Geschütztürme:
obj.Defeat The Hive	Bezwingen Sie die Aliens!
obj.Master killed:	Meister getötet:
obj.no	Nein
obj.YES	JA
obj.Breeder destroyed:	Brüter zerstört:
		
// 22		
obj.Reach Onkar's place of death	Erreichen Sie Onkars Sterbeort!
obj.Take the diary	Nehmen Sie Onkars Tagebuch!
obj.Reach the extraction point	Gelangen Sie zum Evakuierungspunkt!
		
// 23		
obj.Scout the area	Erkunden Sie das Gebiet!
obj.Follow the path	Folgen Sie dem Pfad!
obj.Protect the technicians	Beschützen Sie die Techniker!
obj.Technicians alive	Überlebende Techniker:
obj.Examine the ancient device	Untersuchen Sie das alte Gerät!
obj.Activate the power generator	Aktivieren Sie den Energiegenerator!
obj.Find another ancient device	Finden Sie ein weiteres altes Gerät!
obj.Examine the ruins	Untersuchen Sie die Ruinen!
obj.Return to the first site	Kehren Sie an den Ausgangsort zurück!
obj.Find power	Finden Sie Energie!
obj.Find the ancient power source	Finden Sie die alte Energiequelle!
obj.Reach the extraction point	Gelangen Sie zum Evakuierungspunkt!
		
// 24		
obj.Help the mutants	Helfen Sie den Mutanten!
obj.Help the village defenders	Helfen Sie den Dorfverteidigern!
obj.Kill the Big One	Erledigen Sie die Gigantin!
obj.Explore the area ahead	Erkunden Sie das Gebiet, das vor Ihnen liegt!
obj.Search the area ahead	Durchsuchen Sie das vor Ihnen liegende Gebiet!
		
// 25		
obj.Find Esperanza gates	Finden Sie die Tore von Esperanza!
obj.Enter Esperanza	Betreten Sie Esperanza!
obj.Disable the gate forcefield	Deaktivieren Sie das Kraftfeld am Tor!
obj.Protect the entrance	Beschützen Sie den Eingang!
		
// 26		
obj.Open the gates	Öffnen Sie die Tore!
obj.Eliminate the aliens	Eliminieren Sie die Aliens!
obj.Find the ancient device	Finden Sie den Ursprung des Signals!
		
// 31		
obj.Find Tharksh's ship	Finden Sie Tharkshs Schiff!
obj.Protect the Psi Resonator	Beschützen Sie den Psi-Resonator!
obj.Defeat the enemy Master	Bezwingen Sie den feindlichen Meister!
		
// 32		
obj.Locate the enemy base	Finden Sie das feindliche Lager!
obj.Destroy the enemy base	Zerstören Sie das feindliche Lager!
obj.Protect the ship	Beschützen Sie das Schiff!
obj.Ship hull:	Schiffsrumpf:
obj.Deal with the gas	Kümmern Sie sich um das Gas!
		
// 33		
obj.Protect the ship	Beschützen Sie das Schiff!
obj.Time until next turret arrives:	Zeit bis zur Ankunft des nächsten Geschützturms:
obj.Help the mutants	Helfen Sie den Mutanten!
obj.Destroy the AA site	Zerstören Sie die Flugabwehr!
obj.AA facility hull	Außenhülle der Flugabwehrstellung
		
// 34		
obj.Proceed onward	Folgen Sie dem Pfad!
obj.Protect the Psi Resonator	Beschützen Sie den Psi-Resonator!
obj.Eliminate Vasilii	Beseitigen Sie Vasilii!
obj.Vasilii health left:	Vasiliis Gesundheit:
obj.Destroy the mutants temple	Zerstören Sie den Tempel der Mutanten!
obj.Temple hit points:	Trefferpunkte des Tempels:
obj.Secure the landing zone	Verteidigen Sie den Landeplatz!
obj.Time until the ship arrives:	Zeit bis zur Ankunft des Schiffs:
		
// 35		
obj.Escort Eji to the Shard	Begleiten Sie Eji zur Scherbe!
obj.Disable the teleporter	Deaktivieren Sie den Teleporter!
obj.Find the teleporter controls	Finden Sie die Teleportersteuerung!
obj.Use only alien units	Setzen Sie nur Jaar-Lash-Einheiten ein!
obj.Activate the teleporter	Aktivieren Sie den Teleporter!
obj.Teleport all friendly units	Teleportieren Sie alle verbündeten Einheiten!
obj.Use the teleporter to escape	Fliehen Sie mit dem Teleporter!
obj.All avatars must be in range	Alle Charaktere müssen in Reichweite sein!
		
// 36		
obj.Attack the enemy psychic	Greifen Sie den feindlichen Spiritisten an!
obj.Protect Eji	Beschützen Sie Eji!
obj.Find suitable spot for Eji	Finden Sie eine geeignete Stelle für Eji!
		
// ROM		
obj.Engage HF1337	Greifen Sie HF1337 an!
obj.Shuttle arrives in:	Schiffsankunft in:
obj.Destroy HF1337	Zerstören Sie HF1337!
obj.Hull:	Rumpf:
obj.Energy:	Energie:
obj.Deactivate the cannon	Deaktivieren Sie das Geschütz!
obj.Power cores left:	Verbliebene Energiezellen:
		
// JUNKYARD		
obj.Teleport	Teleportieren!
obj.Clean up time:	Beute-Räumungszeit:
obj.Defeat Gorgar the Late	Bezwingen Sie Gorgar 2.0!
obj.Defeat Trashmaster Ditz	Bezwingen Sie Schrottmeister Ditz!
obj.Defeat Xessk	Bezwingen Sie Xessk!
		
// BSA		
obj.Defeat the Battle Yamu	Bezwingen Sie das Kampf-Yamu!
obj.Defeat the Howling Horror	Bezwingen Sie das Reptil!
obj.Defeat all enemies	Bezwingen Sie alle Feinde!
obj.Defeat the machines	Bezwingen Sie die Maschinen!
obj.Defeat the third wave	Bezwingen Sie die dritte Welle!
obj.Defeat the Hellfires	Bezwingen Sie die Höllenfeuer!
obj.Go to start position	Begeben Sie sich zur Startposition!
obj.Enter The Arena	Betreten Sie die Arena!
		
// DTB		
obj.investigate_dtb	Finden Sie den Commander des Stützpunktes!
obj.kill_frank	Eliminate Frank N. Stein	Eliminieren Sie Frank N. Stein!
obj.kill_adam	Erledigen Sie Adam!
		
// Kharum		
obj.Defeat Trashmaster Ulv	Bezwingen Sie Schrottmeister Ulv!
obj.Protect the village	Beschützen Sie das Dorf!
obj.Help the villagers to survive the attack	Helfen Sie den Dorfbewohnern, den Angriff zu überstehen!
obj.Village is safe	Das Dorf ist in Sicherheit!
obj.Talk to the village's High Priest	Sprechen Sie mit dem Hohepriester des Dorfes!
obj.Eliminate the threat	Beseitigen Sie die Bedrohung!
obj.Attack sources neutralized:	Neutralisierte Bedrohungen:
obj.Threat eliminated	Bedrohung beseitigt.
obj.Talk to Ran Boo	Sprechen Sie mit Ran Boo!
obj.Find Ran Boo	Finden Sie Ran Boo!
obj.Return to the village	Kehren Sie zum Dorf zurück!
obj.Engage Trashmaster Ulv	Greifen Sie Schrottmeister Ulv an!
obj.Activate the ancient device	Aktivieren Sie das alte Gerät!
obj.Power sources activated:	Aktivierte Energiequellen:
obj.Help the village	Helfen Sie dem Dorf!
		
// Safari		
obj.Kill the Queen	Erledigen Sie die Königin!
obj.Kill Mech 0	Erledigen Sie Mech 0!
obj.Kill Jack	Erledigen Sie Jack!
obj.Find Bill	Finden Sie Bill!
obj.Kill Bill	Erledigen Sie Bill!
obj.Explore the area	Erkunden Sie das Gebiet!
