sid	text:fr
	
// 11	
obj.Clear the way	Nettoyer le terrain
obj.Eliminate the hostile creatures	Éliminer les créatures hostiles
obj.Save Denkar	Sauver Denkar
obj.Avoid the patrols	Éviter les patrouilles
	
// 12	
obj.Get help	Obtenir de l’aide
obj.Helpers:	Rassembler les renforts
obj.Help the village	Atteindre le village
obj.Defenders alive:	Défenseurs en vie :
obj.Clear the enemy camp	Nettoyer le camp ennemi
obj.Enemies left:	Ennemis restants :
	
// 13	
obj.Protect the xenolite	Protéger la xénolite
obj.Defenders alive:	Défenseurs en vie :
obj.Sneak in the camp	Infiltrer le camp
obj.Return to the village	Revenir au village
obj.Save Eji	Sauver Eji
obj.Village defenders alive	Défenseurs du village vivants :
obj.Escape the village	S’enfuir du village
	
// 14	
obj.Enter the camp	Entrer dans le camp
obj.Find escape vehicle	S’échapper avec un véhicule
obj.Eliminate the mine defenders	Éliminer les gardes de la mine
	
// 15	
obj.Approach Saling	Approcher de Saling
obj.Find your way to Saling	Atteindre Saling
obj.Make your way past the camp	Franchir le camp
obj.Defeat the Salingian Commander	Vaincre le commandant de Saling
obj.Continue to Saling	Continuer vers Saling
obj.Avoid the fire bursts	Éviter les flammes
	
// 16	
obj.Enter the base	Entrer dans la base
obj.Remove the guards from the road	Se débarrasser des gardes
obj.Sneak through the base	Infiltrer la base
obj.Reach the service entrance	Atteindre l’entrée de service
	
// 21	
obj.Protect the village	Protéger le village
obj.Defenders alive:	Défenseurs en vie :
obj.Protect the lab	Protéger le labo
obj.Turrets left:	Canons-tours restants :
obj.Defeat The Hive	Vaincre les extra-terrestres
obj.Master killed:	Maître tué :
obj.no	non
obj.YES	OUI
obj.Breeder destroyed:	Formatrice détruite :
	
// 22	
obj.Reach Onkar's place of death	Atteindre le lieu où est mort Onkar
obj.Take the diary	Prendre le journal d’Onkar
obj.Reach the extraction point	Atteindre le point d’extraction
	
// 23	
obj.Scout the area	Explorer le secteur
obj.Follow the path	Suivre le sentier
obj.Protect the technicians	Protéger les techniciens
obj.Technicians alive	Techniciens vivants
obj.Examine the ancient device	Examiner l’ancien appareil
obj.Activate the power generator	Activer le générateur d’alimentation
obj.Find another ancient device	Trouver un autre ancien appareil
obj.Examine the ruins	Examiner les ruines
obj.Return to the first site	Revenir au premier site
obj.Find power	Trouver de l’énergie
obj.Find the ancient power source	Trouver la source d’énergie ancienne
obj.Reach the extraction point	Atteindre le point d’extraction
	
// 24	
obj.Help the mutants	Aider les mutants
obj.Help the village defenders	Aider les défenseurs du village
obj.Kill the Big One	Tuer la Pondeuse
obj.Explore the area ahead	Explorer la suite du secteur
obj.Search the area ahead	Fouiller la suite du secteur
	
// 25	
obj.Find Esperanza gates	Trouver les portes d’Esperanza
obj.Enter Esperanza	Entrer dans Esperanza
obj.Disable the gate forcefield	Désactiver le champ de force de la porte
obj.Protect the entrance	Protéger l’entrée
	
// 26	
obj.Open the gates	Ouvrir les portes
obj.Eliminate the aliens	Éliminer les extra-terrestres
obj.Find the ancient device	Trouve la source du signal
	
// 31	
obj.Find Tharksh's ship	Trouver le vaisseau de Tharksh
obj.Protect the Psi Resonator	Protéger le résonateur Psi
obj.Defeat the enemy Master	Vaincre le Maître ennemi
	
// 32	
obj.Locate the enemy base	Trouver le camp ennemi
obj.Destroy the enemy base	Détruire le camp ennemi
obj.Protect the ship	Protéger le vaisseau
obj.Ship hull:	Carlingue du vaisseau :
obj.Deal with the gas	S’occuper du gaz
	
// 33	
obj.Protect the ship	Protéger le vaisseau
obj.Time until next turret arrives:	Temps avant le prochain canon-tour :
obj.Help the mutants	Aider les mutants
obj.Destroy the AA site	Détruire le site AA
obj.AA facility hull	Protection du site AA
	
// 34	
obj.Proceed onward	Suivre le chemin
obj.Protect the Psi Resonator	Protéger le résonateur Psi
obj.Eliminate Vasilii	Éliminer Vasilii
obj.Vasilii health left:	Santé de Vasilii :
obj.Destroy the mutants temple	Détruire le temple mutant
obj.Temple hit points:	Points de vie du temple :
obj.Secure the landing zone	Défendre la zone d’atterrissage
obj.Time until the ship arrives:	Temps avant l’arrivée du vaisseau :
	
// 35	
obj.Escort Eji to the Shard	Escorter Eji au Shard
obj.Disable the teleporter	Désactiver le téléporteur
obj.Find the teleporter controls	Trouver les commandes du téléporteur
obj.Use only alien units	Utiliser uniquement des unités Jaar Lash
obj.Activate the teleporter	Activer le téléporteur
obj.Teleport all friendly units	Téléporter les unités alliées
obj.Use the teleporter to escape	S’échapper avec le téléporteur
obj.All avatars must be in range	Tous les personnages doivent être à portée
	
// 36	
obj.Attack the enemy psychic	Attaquer le télépathe ennemi
obj.Protect Eji	Protéger Eji
obj.Find suitable spot for Eji	Trouver un bon endroit pour Eji
	
// ROM	
obj.Engage HF1337	Attaquer le HF1337
obj.Shuttle arrives in:	Arrivée de la navette dans :
obj.Destroy HF1337	Détruire le HF1337
obj.Hull:	Carlingue :
obj.Energy:	Énergie :
obj.Deactivate the cannon	Désactiver le canon
obj.Power cores left:	Noyaux d’alimentation restants :
	
// JUNKYARD	
obj.Teleport	Téléporter
obj.Clean up time:	Temps de nettoyage :
obj.Defeat Gorgar the Late	Vaincre Gorgar le tardif
obj.Defeat Trashmaster Ditz	Vaincre Trashmaster Ditz
obj.Defeat Xessk	Vaincre Xessk
	
// BSA	
obj.Defeat the Battle Yamu	Vaincre le Yamu de combat
obj.Defeat the Howling Horror	Vaincre l’Horreur monstrueuse
obj.Defeat all enemies	Vaincre tous les ennemis
obj.Defeat the machines	Vaincre les machines
obj.Defeat the third wave	Vaincre la troisième vague
obj.Defeat the Hellfires	Vaincre les Feux de l’enfer
obj.Go to start position	Revenir à la position de départ
obj.Enter The Arena	Entrer dans l’Arène
	
// DTB	
obj.investigate_dtb	Localiser le commandant de la base
obj.kill_frank	Éliminer Frank N. Stein
obj.kill_adam	Tuer Adam
	
// Kharum	
obj.Defeat Trashmaster Ulv	Vaincre Trashmaster Ulv
obj.Protect the village	Protéger le village
obj.Help the villagers to survive the attack	Aider les villageois à survivre à l’attaque
obj.Village is safe	Le village est sauf
obj.Talk to the village's High Priest	Parler au Grand prêtre du village
obj.Eliminate the threat	Éliminer la menace
obj.Attack sources neutralized:	Sources d’attaque neutralisées :
obj.Threat eliminated	Menaces éliminées
obj.Talk to Ran Boo	Parler à Ran Boo
obj.Find Ran Boo	Trouver Ran Boo
obj.Return to the village	Revenir au village
obj.Engage Trashmaster Ulv	Attaquer Trashmaster Ulv
obj.Activate the ancient device	Activer l’ancien appareil
obj.Power sources activated:	Sources d’alimentation activées :
obj.Help the village	Aider le village
	
// Safari	
obj.Kill the Queen	Tuer la reine
obj.Kill Mech 0	Tuer le robot 0
obj.Kill Jack	Tuer Jack
obj.Find Bill	Trouver Bill
obj.Kill Bill	Tuer Bill
obj.Explore the area	Explorer le secteur
